St. Thomas Aquinas: Summa Theologica, Prima Pars 
 
 
 
 SUMMA THEOLOGICA 
 
ANGELICI DOCTORIS SANCTI THOMAE AQUINATIS
 
 PRIMA PARS 
 
 
 
 

 
	 Quaestio I: De sacra doctrina.


 
	 Quaestio II: De Deo, an Deus sit.

 
	 Quaestio III: De Dei simplicitate.

 
	 Quaestio IV: De Dei perfectione.
 
	 Quaestio V: De bono in communi.
 
	 Quaestio VI: De bonitate Dei.

 
	 Quaestio VII: De infinitate Dei.
 
	 Quaestio VIII: De existentia Dei in rebus.
 
	 Quaestio IX: De Dei immutabilitate.
 
	 Quaestio X: De Dei aeternitate.
 
	 Quaestio XI: De unitate Dei.
 
	 Quaestio XII: Quomodo Deus a nobis cognoscatur.
 
	 Quaestio XIII: De nominibus Dei.
 
	 Quaestio XIV: De scientia Dei.
 
	 Quaestio XV: De ideis.
 
	 Quaestio XVI: De veritate.
 
	 Quaestio XVII: De falsitate.
 
	 Quaestio XVIII: De vita Dei.
 
	 Quaestio XIX: De voluntate Dei.
 
	 Quaestio XX: De amore Dei.
 
	 Quaestio XXI: De iustitia et misericordia Dei.
 
	 Quaestio XXII: De providentia Dei.
 
	 Quaestio XXIII: De praedestinatione.
 
	 Quaestio XXIV: De libro vitae.
 
	 Quaestio XXV: De divina potentia.
 
	 Quaestio XXVI: De divina beatitudine.
 
	 Quaestio XXVII: De processione divinarum Personarum.
 
	 Quaestio XXVIII: De relationibus divinis.
 
	 Quaestio XXIX: De Personis divinis.
 
	 Quaestio XXX: De pluralitate Personarum in divinis.
 
	 Quaestio XXXI: De his quae ad unitatem vel pluralitatem pertinent in divinis.
 
	 Quaestio XXXII: De divinarum Personarum cognitione.
 
	 Quaestio XXXIII: De persona Patris.
 
	 Quaestio XXXIV: De persona Filii.
 
	 Quaestio XXXV: De Imagine.
 
	 Quaestio XXXVI: De persona Spiritus Sancti.
 
	 Quaestio XXXVII: De nomine Spiritus Sancti quod est Amor.
 
	 Quaestio XXXVIII: De nomine Spiritus Sancti quod est Donum.
 
	 Quaestio XXXIX: De Personis ad essentiam relatis.
 
	 Quaestio XL: De personis in comparatione ad relationes sive proprietates.
 
	 Quaestio XLI: De Personis in comparatione ad actus notionales.
 
	 Quaestio XLII: De aequalitate et similitudine divinarum Personarum ad invicem.
 
	 Quaestio XLIII: De missione divinarum Personarum.
 
	 Quaestio XLIV: De processione creaturarum a Deo, et de omnium entium prima causa.
 
	 Quaestio XLV: De modo emanationis rerum a primo principio.
 
	 Quaestio XLVI: De principio durationis rerum creatarum.
 
	 Quaestio XLVII: De distinctione rerum in communi.
 
	 Quaestio XLVIII: De distinctione rerum in speciali.
 
	 Quaestio XLIX: De causa mali.
 
	 Quaestio L: De substantia angelorum absolute.
 
	 Quaestio LI: De comparatione angelorum ad corpora.
 
	 Quaestio LII: De comparatione angelorum ad loca.
 
	 Quaestio LIII: De motu locali angelorum.
 
	 Quaestio LIV: De cognitione angelorum.
 
	 Quaestio LV: De medio cognitionis angelicae.
 
	 Quaestio LVI: De cognitione angelorum ex parte rerum immaterialium.
 
	 Quaestio LVII: De angelorum cognitione respectu rerum materialium.
 
	 Quaestio LVIII: De modo cognitionis angelicae.
 
	 Quaestio LIX: De voluntate angelorum.
 
	 Quaestio LX: De amore seu dilectione angelorum.
 
	 Quaestio LXI: De productione angelorum in esse naturae.
 
	 Quaestio LXII: De perfectione angelorum in esse gratiae et gloriae.
 
	 Quaestio LXIII: De angelorum malitia quoad culpam.
 
	 Quaestio LXIV: De poena daemonum.
 
	 Quaestio LXV: De opere creationis creaturae corporalis.
 
	 Quaestio LXVI: De ordine creationis ad distinctionem.
 
	 Quaestio LXVII: De opere distinctionis secundum se.
 
	 Quaestio LXVIII: De opere secundae diei.
 
	 Quaestio LXIX: De opere tertiae diei.
 
	 Quaestio LXX: De opere ornatus, quantum ad quartam diem.
 
	 Quaestio LXXI: De opere quintae diei.
 
	 Quaestio LXXII: De opere sextae diei.
 
	 Quaestio LXXIII: De iis quae pertinent ad septimum diem.
 
	 Quaestio LXXIV: De omnibus septem diebus in communi.
 
	 Quaestio LXXV: De homine, qui ex spirituali et corporali substantia componitur.
 
	 Quaestio LXXVI: De unione animae ad corpus.
 
	 Quaestio LXXVII: De his quae pertinent ad potentias animae in generali.
 
	 Quaestio LXXVIII: De potentiis animae in speciali.
 
	 Quaestio LXXIX: De potentiis intellectivis.
 
	 Quaestio LXXX: De potentiis appetitivis in communi.
 
	 Quaestio LXXXI: De sensualitate.
 
	 Quaestio LXXXII: De voluntate.
 
	 Quaestio LXXXIII: De libero arbitrio.
 
	 Quaestio LXXXIV: Quomodo anima coniuncta intelligat corporalia quae sunt infra ipsam.
 
	 Quaestio LXXXV: De modo et ordine intelligendi.
 
	 Quaestio LXXXVI: Quid intellectus noster in rebus materialibus cognoscat.
 
	 Quaestio LXXXVII: Quomodo anima intellectiva seipsam, et ea quae sunt in ipsa, cognoscat arbitrio.
 
 
  St. Thomas Aquinas 
 Christian Latin The Latin Library The Classics Page